----------
--Ss------
ppp-------
----------
S-c-------
ppp-cc----
--s---cs--
c-----pp--
ppp-------