----------
--S-------
ppp-------
----------
S-c-------
ppp-------
------cs--
c-----pp--
ppp-------