--c-----pp
ppppp-----
----------
--c-------
----------
----------
pppppppppp
----------
----------